Season,Team,team-abbr,team-year,G,MP,FG,FGA,FG.pct,3P,3PA,3P.pct,2P,2PA,2P.pct,FT,FTA,FT.pct,ORB,DRB,TRB,AST,STL,BLK,TOV,PF,PTS
2017,Golden State Warriors,GSW,GSW-2017,82,19780,3532,7140,0.495,982,2562,0.383,2550,4578,0.557,1457,1850,0.788,770,2873,3643,2491,785,555,1211,1585,9503
2017,Houston Rockets,HOU,HOU-2017,82,19780,3305,7152,0.462,1181,3306,0.357,2124,3846,0.552,1667,2177,0.766,892,2746,3638,2070,670,352,1240,1634,9458
2017,Denver Nuggets,DEN,DEN-2017,82,19755,3377,7194,0.469,870,2365,0.368,2507,4829,0.519,1537,1986,0.774,966,2837,3803,2077,568,323,1226,1567,9161
2017,Cleveland Cavaliers,CLE,CLE-2017,82,19880,3275,6963,0.47,1067,2779,0.384,2208,4184,0.528,1431,1913,0.748,766,2821,3587,1858,539,327,1121,1486,9048
2017,Washington Wizards,WAS,WAS-2017,82,19855,3388,7137,0.475,756,2030,0.372,2632,5107,0.515,1421,1812,0.784,843,2671,3514,1956,693,336,1162,1745,8953
2017,Los Angeles Clippers,LAC,LAC-2017,82,19755,3242,6820,0.475,841,2245,0.375,2401,4575,0.525,1586,2128,0.745,738,2790,3528,1848,612,347,1062,1626,8911
2017,Boston Celtics,BOS,BOS-2017,82,19755,3168,6978,0.454,985,2742,0.359,2183,4236,0.515,1536,1903,0.807,744,2698,3442,2069,617,340,1088,1686,8857
2017,Portland Trail Blazers,POR,POR-2017,82,19930,3243,7059,0.459,852,2272,0.375,2391,4787,0.499,1513,1940,0.78,830,2750,3580,1733,574,408,1126,1736,8851
2017,Phoenix Suns,PHX,PHX-2017,82,19830,3270,7260,0.45,615,1854,0.332,2655,5406,0.491,1676,2159,0.776,976,2712,3688,1604,673,399,1265,2030,8831
2017,Toronto Raptors,TOR,TOR-2017,82,19780,3211,6918,0.464,725,1996,0.363,2486,4922,0.505,1615,2028,0.796,871,2676,3547,1517,677,400,1041,1708,8762
2017,Oklahoma City Thunder,OKC,OKC-2017,82,19805,3237,7169,0.452,692,2116,0.327,2545,5053,0.504,1575,2113,0.745,1002,2821,3823,1721,648,408,1230,1715,8741
2017,Brooklyn Nets,BKN,BKN-2017,82,19755,3102,6987,0.444,877,2591,0.338,2225,4396,0.506,1592,2020,0.788,721,2879,3600,1756,593,387,1356,1726,8673
2017,Minnesota Timberwolves,MIN,MIN-2017,82,19805,3235,6922,0.467,601,1723,0.349,2634,5199,0.507,1586,1986,0.799,938,2540,3478,1940,654,370,1150,1646,8657
2017,San Antonio Spurs,SAS,SAS-2017,82,19805,3222,6864,0.469,753,1927,0.391,2469,4937,0.5,1440,1806,0.797,821,2777,3598,1954,655,484,1101,1498,8637
2017,Indiana Pacers,IND,IND-2017,82,19855,3221,6931,0.465,709,1885,0.376,2512,5046,0.498,1467,1811,0.81,742,2702,3444,1844,669,409,1130,1597,8618
2017,Charlotte Hornets,CHA,CHA-2017,82,19830,3093,7000,0.442,824,2347,0.351,2269,4653,0.488,1591,1953,0.815,721,2853,3574,1891,571,390,942,1360,8601
2017,Los Angeles Lakers,LAL,LAL-2017,82,19705,3224,7164,0.45,730,2110,0.346,2494,5054,0.493,1397,1853,0.754,933,2636,3569,1716,674,320,1243,1698,8575
2017,New Orleans Pelicans,NOP,NOP-2017,82,19905,3210,7130,0.45,768,2196,0.35,2442,4934,0.495,1368,1825,0.75,703,2879,3582,1869,638,453,1054,1490,8556
2017,New York Knicks,NYK,NYK-2017,82,19855,3244,7256,0.447,704,2022,0.348,2540,5234,0.485,1364,1731,0.788,983,2723,3706,1786,581,455,1139,1668,8556
2017,Milwaukee Bucks,MIL,MIL-2017,82,19780,3182,6715,0.474,720,1946,0.37,2462,4769,0.516,1413,1839,0.768,723,2589,3312,1984,666,436,1145,1660,8497
2017,Miami Heat,MIA,MIA-2017,82,19780,3202,7037,0.455,808,2213,0.365,2394,4824,0.496,1248,1768,0.706,872,2705,3577,1742,588,469,1102,1680,8460
2017,Atlanta Hawks,ATL,ATL-2017,82,19880,3123,6918,0.451,729,2137,0.341,2394,4781,0.501,1484,2039,0.728,842,2793,3635,1938,672,397,1294,1491,8459
2017,Chicago Bulls,CHI,CHI-2017,82,19780,3169,7141,0.444,623,1831,0.34,2546,5310,0.479,1474,1848,0.798,999,2797,3796,1851,643,393,1112,1455,8435
2017,Sacramento Kings,SAC,SAC-2017,82,19880,3105,6734,0.461,737,1960,0.376,2368,4774,0.496,1483,1913,0.775,715,2652,3367,1844,627,324,1201,1667,8430
2017,Philadelphia 76ers,PHI,PHI-2017,82,19830,3088,6992,0.442,831,2443,0.34,2257,4549,0.496,1393,1806,0.771,807,2706,3513,1949,692,420,1366,1793,8400
2017,Detroit Pistons,DET,DET-2017,82,19805,3269,7282,0.449,631,1915,0.33,2638,5367,0.492,1140,1586,0.719,908,2838,3746,1732,574,310,973,1467,8309
2017,Orlando Magic,ORL,ORL-2017,82,19805,3139,7133,0.44,701,2139,0.328,2438,4994,0.488,1309,1753,0.747,807,2734,3541,1820,580,396,1091,1584,8288
2017,Utah Jazz,UTA,UTA-2017,82,19755,3033,6515,0.466,791,2128,0.372,2242,4387,0.511,1401,1875,0.747,771,2774,3545,1651,550,410,1118,1545,8258
2017,Memphis Grizzlies,MEM,MEM-2017,82,19905,2984,6854,0.435,767,2169,0.354,2217,4685,0.473,1504,1918,0.784,886,2621,3507,1744,653,344,1059,1840,8239
2017,Dallas Mavericks,DAL,DAL-2017,82,19780,2968,6750,0.44,878,2473,0.355,2090,4277,0.489,1215,1516,0.801,647,2516,3163,1705,614,307,972,1567,8029
2016,Golden State Warriors,GSW,GSW-2016,82,19880,3489,7159,0.487,1077,2592,0.416,2412,4567,0.528,1366,1790,0.763,816,2972,3788,2373,689,498,1245,1701,9421
2016,Oklahoma City Thunder,OKC,OKC-2016,82,19830,3372,7082,0.476,678,1945,0.349,2694,5137,0.524,1616,2067,0.782,1071,2916,3987,1883,603,487,1305,1691,9038
2016,Sacramento Kings,SAC,SAC-2016,82,19805,3283,7083,0.464,660,1839,0.359,2623,5244,0.5,1514,2089,0.725,868,2760,3628,2009,733,368,1326,1676,8740
2016,Houston Rockets,HOU,HOU-2016,82,19830,3094,6847,0.452,878,2533,0.347,2216,4314,0.514,1671,2407,0.694,930,2601,3531,1821,821,430,1307,1790,8737
2016,Boston Celtics,BOS,BOS-2016,82,19780,3216,7318,0.439,717,2142,0.335,2499,5176,0.483,1520,1929,0.788,950,2733,3683,1981,752,348,1127,1796,8669
2016,Portland Trail Blazers,POR,POR-2016,82,19805,3167,7040,0.45,864,2336,0.37,2303,4704,0.49,1424,1889,0.754,948,2782,3730,1748,562,380,1200,1782,8622
2016,Los Angeles Clippers,LAC,LAC-2016,82,19830,3141,6759,0.465,797,2190,0.364,2344,4569,0.513,1490,2152,0.692,721,2727,3448,1873,709,460,1063,1746,8569
2016,Cleveland Cavaliers,CLE,CLE-2016,82,19855,3171,6888,0.46,880,2428,0.362,2291,4460,0.514,1333,1783,0.748,873,2777,3650,1861,551,317,1114,1666,8555
2016,Washington Wizards,WAS,WAS-2016,82,19755,3238,7033,0.46,709,1983,0.358,2529,5050,0.501,1349,1849,0.73,743,2688,3431,2005,708,323,1186,1708,8534
2016,San Antonio Spurs,SAS,SAS-2016,82,19705,3289,6797,0.484,570,1518,0.375,2719,5279,0.515,1342,1672,0.803,770,2831,3601,2010,677,485,1071,1433,8490
2016,Charlotte Hornets,CHA,CHA-2016,82,19855,3036,6922,0.439,873,2410,0.362,2163,4512,0.479,1534,1941,0.79,734,2869,3603,1778,595,438,1030,1487,8479
2016,Atlanta Hawks,ATL,ATL-2016,82,19830,3168,6923,0.458,815,2326,0.35,2353,4597,0.512,1282,1638,0.783,679,2772,3451,2100,747,486,1226,1570,8433
2016,New Orleans Pelicans,NOP,NOP-2016,82,19780,3153,7040,0.448,702,1951,0.36,2451,5089,0.482,1415,1823,0.776,782,2712,3494,1818,633,342,1102,1713,8423
2016,Toronto Raptors,TOR,TOR-2016,82,19780,3006,6669,0.451,708,1915,0.37,2298,4754,0.483,1702,2190,0.777,836,2724,3560,1536,636,449,1073,1610,8422
2016,Minnesota Timberwolves,MIN,MIN-2016,82,19880,3095,6668,0.464,455,1347,0.338,2640,5321,0.496,1753,2213,0.792,821,2587,3408,1916,656,375,1231,1696,8398
2016,Dallas Mavericks,DAL,DAL-2016,82,20005,3064,6900,0.444,806,2342,0.344,2258,4558,0.495,1454,1831,0.794,751,2781,3532,1813,560,306,1047,1595,8388
2016,Indiana Pacers,IND,IND-2016,82,19880,3142,6985,0.45,663,1889,0.351,2479,5096,0.486,1430,1872,0.764,847,2779,3626,1741,742,391,1219,1641,8377
2016,Orlando Magic,ORL,ORL-2016,82,19905,3242,7120,0.455,636,1818,0.35,2606,5302,0.492,1249,1649,0.757,843,2709,3552,1933,673,417,1155,1701,8369
2016,Detroit Pistons,DET,DET-2016,82,19880,3111,7087,0.439,740,2148,0.345,2371,4939,0.48,1399,2095,0.668,1021,2777,3798,1594,573,304,1110,1557,8361
2016,Denver Nuggets,DEN,DEN-2016,82,19830,3093,7003,0.442,656,1943,0.338,2437,5060,0.482,1513,1974,0.766,941,2718,3659,1858,609,395,1202,1723,8355
2016,Chicago Bulls,CHI,CHI-2016,82,19905,3165,7170,0.441,651,1753,0.371,2514,5417,0.464,1354,1720,0.787,907,2889,3796,1870,495,470,1141,1545,8335
2016,Phoenix Suns,PHX,PHX-2016,82,19705,3051,7018,0.435,738,2118,0.348,2313,4900,0.472,1431,1905,0.751,943,2733,3676,1701,632,313,1410,1858,8271
2016,Miami Heat,MIA,MIA-2016,82,19830,3150,6697,0.47,498,1480,0.336,2652,5217,0.508,1406,1889,0.744,807,2811,3618,1709,553,531,1155,1502,8204
2016,Memphis Grizzlies,MEM,MEM-2016,82,19830,3019,6859,0.44,504,1521,0.331,2515,5338,0.471,1584,2024,0.783,916,2497,3413,1697,724,350,1090,1783,8126
2016,Milwaukee Bucks,MIL,MIL-2016,82,19830,3145,6740,0.467,440,1277,0.345,2705,5463,0.495,1392,1863,0.747,858,2559,3417,1895,672,475,1247,1695,8122
2016,Brooklyn Nets,BKN,BKN-2016,82,19755,3136,6920,0.453,531,1508,0.352,2605,5412,0.481,1286,1699,0.757,863,2614,3477,1829,627,332,1212,1476,8089
2016,New York Knicks,NYK,NYK-2016,82,19805,3022,6886,0.439,610,1762,0.346,2412,5124,0.471,1411,1753,0.805,850,2788,3638,1682,467,466,1099,1616,8065
2016,Utah Jazz,UTA,UTA-2016,82,19955,2957,6593,0.449,694,1956,0.355,2263,4637,0.488,1402,1885,0.744,880,2665,3545,1555,631,425,1224,1655,8010
2016,Philadelphia 76ers,PHI,PHI-2016,82,19805,2970,6887,0.431,764,2255,0.339,2206,4632,0.476,1284,1850,0.694,777,2605,3382,1765,680,495,1343,1780,7988
2016,Los Angeles Lakers,LAL,LAL-2016,82,19730,2880,6956,0.414,639,2016,0.317,2241,4940,0.454,1583,2028,0.781,878,2645,3523,1478,593,337,1124,1662,7982
2015,Golden State Warriors,GSW,GSW-2015,82,19730,3410,7137,0.478,883,2217,0.398,2527,4920,0.514,1313,1709,0.768,853,2814,3667,2248,762,496,1185,1628,9016
2015,Los Angeles Clippers,LAC,LAC-2015,82,19730,3228,6830,0.473,827,2202,0.376,2401,4628,0.519,1468,2067,0.71,784,2711,3495,2031,640,409,1012,1749,8751
2015,Dallas Mavericks,DAL,DAL-2015,82,19880,3255,7036,0.463,732,2082,0.352,2523,4954,0.509,1386,1843,0.752,858,2608,3466,1846,663,371,1062,1644,8628
2015,Toronto Raptors,TOR,TOR-2015,82,19855,3108,6829,0.455,726,2060,0.352,2382,4769,0.499,1585,2014,0.787,881,2526,3407,1701,615,357,1057,1712,8527
2015,Oklahoma City Thunder,OKC,OKC-2015,82,19830,3184,7119,0.447,632,1864,0.339,2552,5255,0.486,1524,2020,0.754,1052,2844,3896,1681,598,454,1205,1829,8524
2015,Houston Rockets,HOU,HOU-2015,82,19805,3032,6832,0.444,933,2680,0.348,2099,4152,0.506,1525,2133,0.715,958,2624,3582,1820,777,407,1366,1803,8522
2015,San Antonio Spurs,SAS,SAS-2015,82,19955,3208,6854,0.468,677,1847,0.367,2531,5007,0.505,1368,1754,0.78,806,2772,3578,2000,657,444,1146,1564,8461
2015,Cleveland Cavaliers,CLE,CLE-2015,82,19780,3089,6739,0.458,826,2253,0.367,2263,4486,0.504,1453,1934,0.751,911,2612,3523,1814,603,340,1171,1510,8457
2015,Portland Trail Blazers,POR,POR-2015,82,19855,3175,7049,0.45,807,2231,0.362,2368,4818,0.491,1272,1589,0.801,879,2881,3760,1799,525,372,1117,1494,8429
2015,Atlanta Hawks,ATL,ATL-2015,82,19730,3121,6699,0.466,818,2152,0.38,2303,4547,0.506,1349,1735,0.778,715,2611,3326,2111,744,380,1167,1457,8409
2015,Phoenix Suns,PHX,PHX-2015,82,19880,3178,7038,0.452,698,2048,0.341,2480,4990,0.497,1343,1767,0.76,896,2643,3539,1659,700,385,1238,1744,8397
2015,Denver Nuggets,DEN,DEN-2015,82,19880,3099,7158,0.433,660,2032,0.325,2439,5126,0.476,1462,1991,0.734,1012,2653,3665,1788,641,367,1166,1882,8320
2015,Boston Celtics,BOS,BOS-2015,82,19880,3193,7211,0.443,660,2021,0.327,2533,5190,0.488,1266,1678,0.754,910,2685,3595,2009,674,294,1133,1738,8312
2015,Sacramento Kings,SAC,SAC-2015,82,19855,3010,6617,0.455,461,1350,0.341,2549,5267,0.484,1829,2400,0.762,895,2728,3623,1667,550,324,1333,1696,8310
2015,Chicago Bulls,CHI,CHI-2015,82,19880,3001,6797,0.442,645,1825,0.353,2356,4972,0.474,1618,2067,0.783,959,2792,3751,1781,514,476,1145,1495,8265
2015,New Orleans Pelicans,NOP,NOP-2015,82,19780,3108,6795,0.457,586,1583,0.37,2522,5212,0.484,1345,1790,0.751,942,2621,3563,1806,553,510,1087,1530,8147
2015,Washington Wizards,WAS,WAS-2015,82,19955,3139,6790,0.462,497,1381,0.36,2642,5409,0.488,1305,1758,0.742,862,2801,3663,1969,601,378,1233,1707,8080
2015,Detroit Pistons,DET,DET-2015,82,19830,3041,7038,0.432,703,2043,0.344,2338,4995,0.468,1292,1838,0.703,1051,2630,3681,1771,623,383,1099,1559,8077
2015,Los Angeles Lakers,LAL,LAL-2015,82,19930,3054,7020,0.435,532,1546,0.344,2522,5474,0.461,1433,1935,0.741,952,2647,3599,1715,578,366,1086,1741,8073
2015,Memphis Grizzlies,MEM,MEM-2015,82,19905,3097,6763,0.458,423,1246,0.339,2674,5517,0.485,1445,1869,0.773,856,2634,3490,1777,700,347,1094,1567,8062
2015,Brooklyn Nets,BKN,BKN-2015,82,19930,3069,6804,0.451,541,1633,0.331,2528,5171,0.489,1359,1817,0.748,846,2627,3473,1716,576,340,1133,1579,8038
2015,Milwaukee Bucks,MIL,MIL-2015,82,19930,3083,6722,0.459,545,1500,0.363,2538,5222,0.486,1312,1734,0.757,876,2574,3450,1932,789,403,1373,1814,8023
2015,Minnesota Timberwolves,MIN,MIN-2015,82,19805,2986,6820,0.438,406,1223,0.332,2580,5597,0.461,1638,2110,0.776,949,2406,3355,1771,668,327,1231,1571,8016
2015,Indiana Pacers,IND,IND-2015,82,19855,2998,6824,0.439,612,1740,0.352,2386,5084,0.469,1373,1817,0.756,856,2822,3678,1757,505,375,1147,1742,7981
2015,Orlando Magic,ORL,ORL-2015,82,19755,3076,6792,0.453,554,1598,0.347,2522,5194,0.486,1141,1565,0.729,822,2607,3429,1692,647,314,1221,1714,7847
2015,Utah Jazz,UTA,UTA-2015,82,19705,2900,6492,0.447,610,1781,0.343,2290,4711,0.486,1391,1929,0.721,988,2617,3605,1632,623,489,1256,1583,7801
2015,Miami Heat,MIA,MIA-2015,82,19730,2885,6330,0.456,556,1659,0.335,2329,4671,0.499,1438,1940,0.741,747,2461,3208,1626,642,372,1214,1636,7764
2015,Charlotte Hornets,CHA,CHA-2015,82,19905,2913,6932,0.42,498,1566,0.318,2415,5366,0.45,1397,1867,0.748,820,2793,3613,1654,499,448,976,1494,7721
2015,Philadelphia 76ers,PHI,PHI-2015,82,19805,2765,6777,0.408,692,2160,0.32,2073,4617,0.449,1320,1953,0.676,978,2536,3514,1683,789,487,1453,1778,7542
2015,New York Knicks,NYK,NYK-2015,82,19855,2882,6726,0.428,560,1614,0.347,2322,5112,0.454,1211,1575,0.769,867,2443,3310,1746,575,382,1206,1768,7535
2014,Los Angeles Clippers,LAC,LAC-2014,82,19755,3208,6761,0.474,693,1966,0.352,2515,4795,0.525,1741,2384,0.73,858,2668,3526,2016,703,397,1136,1767,8850
2014,Houston Rockets,HOU,HOU-2014,82,19830,3118,6603,0.472,779,2179,0.358,2339,4424,0.529,1814,2549,0.712,920,2797,3717,1755,621,461,1323,1676,8829
2014,Minnesota Timberwolves,MIN,MIN-2014,82,19855,3189,7175,0.444,600,1757,0.341,2589,5418,0.478,1790,2301,0.778,1024,2644,3668,1963,718,297,1142,1504,8768
2014,Portland Trail Blazers,POR,POR-2014,82,19855,3207,7134,0.45,770,2071,0.372,2437,5063,0.481,1569,1926,0.815,1022,2786,3808,1904,454,387,1125,1576,8753
2014,Oklahoma City Thunder,OKC,OKC-2014,82,19805,3194,6782,0.471,664,1839,0.361,2530,4943,0.512,1653,2052,0.806,887,2781,3668,1794,678,501,1256,1858,8705
2014,San Antonio Spurs,SAS,SAS-2014,82,19755,3326,6844,0.486,698,1757,0.397,2628,5087,0.517,1289,1642,0.785,762,2786,3548,2064,604,420,1180,1495,8639
2014,Phoenix Suns,PHX,PHX-2014,82,19755,3172,6845,0.463,765,2055,0.372,2407,4790,0.503,1520,2004,0.758,928,2601,3529,1563,688,374,1258,1798,8629
2014,Dallas Mavericks,DAL,DAL-2014,82,19830,3249,6858,0.474,721,1877,0.384,2528,4981,0.508,1378,1733,0.795,840,2514,3354,1935,704,356,1110,1636,8597
2014,Denver Nuggets,DEN,DEN-2014,82,19755,3147,7042,0.447,702,1959,0.358,2445,5083,0.481,1563,2154,0.726,1009,2717,3726,1838,615,459,1305,1890,8559
2014,Golden State Warriors,GSW,GSW-2014,82,19830,3236,7005,0.462,774,2037,0.38,2462,4968,0.496,1303,1731,0.753,896,2819,3715,1912,642,407,1247,1784,8549
2014,Los Angeles Lakers,LAL,LAL-2014,82,19705,3139,6980,0.45,774,2032,0.381,2365,4948,0.478,1390,1835,0.757,745,2620,3365,2006,611,446,1239,1627,8442
2014,Miami Heat,MIA,MIA-2014,82,19880,3142,6272,0.501,665,1829,0.364,2477,4443,0.558,1431,1884,0.76,627,2397,3024,1847,732,367,1212,1596,8380
2014,Toronto Raptors,TOR,TOR-2014,82,19955,2992,6718,0.445,713,1917,0.372,2279,4801,0.475,1608,2055,0.782,935,2552,3487,1737,577,343,1159,1882,8305
2014,Detroit Pistons,DET,DET-2014,82,19780,3182,7124,0.447,507,1580,0.321,2675,5544,0.483,1415,2111,0.67,1196,2525,3721,1714,687,395,1193,1666,8286
2014,Atlanta Hawks,ATL,ATL-2014,82,19830,3061,6688,0.458,768,2116,0.363,2293,4572,0.502,1392,1782,0.781,713,2565,3278,2041,680,326,1251,1577,8282
2014,Washington Wizards,WAS,WAS-2014,82,20055,3177,6920,0.459,647,1704,0.38,2530,5216,0.485,1253,1715,0.731,886,2573,3459,1909,668,377,1204,1675,8254
2014,Sacramento Kings,SAC,SAC-2014,82,19830,3026,6766,0.447,491,1475,0.333,2535,5291,0.479,1698,2237,0.759,990,2656,3646,1547,587,318,1249,1849,8241
2014,New Orleans Pelicans,NOP,NOP-2014,82,19855,3101,6761,0.459,486,1303,0.373,2615,5458,0.479,1489,1936,0.769,933,2486,3419,1745,647,523,1129,1857,8177
2014,Philadelphia 76ers,PHI,PHI-2014,82,19855,3108,7150,0.435,577,1847,0.312,2531,5303,0.477,1362,1918,0.71,949,2556,3505,1791,765,330,1384,1844,8155
2014,New York Knicks,NYK,NYK-2014,82,19855,3027,6739,0.449,759,2038,0.372,2268,4701,0.482,1271,1670,0.761,870,2437,3307,1641,631,367,1063,1815,8084
2014,Brooklyn Nets,BKN,BKN-2014,82,19880,2931,6391,0.459,709,1922,0.369,2222,4469,0.497,1508,2002,0.753,721,2407,3128,1714,705,311,1191,1777,8079
2014,Cleveland Cavaliers,CLE,CLE-2014,82,19930,3036,6955,0.437,584,1640,0.356,2452,5315,0.461,1398,1861,0.751,989,2629,3618,1738,579,304,1163,1640,8054
2014,Charlotte Hornets,CHA,CHA-2014,82,19905,2976,6730,0.442,516,1471,0.351,2460,5259,0.468,1474,2000,0.737,776,2724,3500,1778,499,421,1010,1493,7942
2014,Indiana Pacers,IND,IND-2014,82,19780,2949,6573,0.449,550,1542,0.357,2399,5031,0.477,1485,1907,0.779,834,2831,3665,1651,550,446,1237,1675,7933
2014,Orlando Magic,ORL,ORL-2014,82,19955,3022,6784,0.445,563,1596,0.353,2459,5188,0.474,1307,1714,0.763,794,2654,3448,1726,630,350,1222,1678,7914
2014,Boston Celtics,BOS,BOS-2014,82,19730,2996,6883,0.435,575,1729,0.333,2421,5154,0.47,1325,1706,0.777,980,2505,3485,1726,584,343,1261,1743,7892
2014,Memphis Grizzlies,MEM,MEM-2014,82,19805,3122,6723,0.464,405,1147,0.353,2717,5576,0.487,1235,1666,0.741,950,2526,3476,1792,631,375,1124,1568,7884
2014,Milwaukee Bucks,MIL,MIL-2014,82,19880,2952,6737,0.438,548,1553,0.353,2404,5184,0.464,1377,1843,0.747,971,2399,3370,1760,541,403,1238,1713,7829
2014,Utah Jazz,UTA,UTA-2014,82,19780,2951,6652,0.444,543,1577,0.344,2408,5075,0.474,1346,1803,0.747,904,2477,3381,1664,570,366,1200,1699,7791
2014,Chicago Bulls,CHI,CHI-2014,82,19930,2843,6577,0.432,508,1459,0.348,2335,5118,0.456,1486,1908,0.779,937,2683,3620,1860,594,424,1223,1565,7680
2013,Denver Nuggets,DEN,DEN-2013,82,19905,3339,6983,0.478,521,1518,0.343,2818,5465,0.516,1505,2148,0.701,1092,2601,3693,2002,762,533,1253,1682,8704
2013,Houston Rockets,HOU,HOU-2013,82,19780,3124,6782,0.461,867,2369,0.366,2257,4413,0.511,1573,2087,0.754,909,2652,3561,1902,679,359,1348,1662,8688
2013,Oklahoma City Thunder,OKC,OKC-2013,82,19830,3126,6504,0.481,598,1588,0.377,2528,4916,0.514,1819,2196,0.828,854,2725,3579,1753,679,624,1253,1654,8669
2013,San Antonio Spurs,SAS,SAS-2013,82,19880,3210,6675,0.481,663,1764,0.376,2547,4911,0.519,1365,1725,0.791,666,2721,3387,2058,695,446,1206,1427,8448
2013,Miami Heat,MIA,MIA-2013,82,19880,3148,6348,0.496,717,1809,0.396,2431,4539,0.536,1423,1887,0.754,676,2490,3166,1890,710,441,1143,1533,8436
2013,Los Angeles Lakers,LAL,LAL-2013,82,19755,3041,6640,0.458,715,2015,0.355,2326,4625,0.503,1584,2289,0.692,942,2732,3674,1818,576,429,1232,1467,8381
2013,Golden State Warriors,GSW,GSW-2013,82,19805,3130,6840,0.458,658,1632,0.403,2472,5208,0.475,1378,1744,0.79,885,2801,3686,1845,567,346,1236,1753,8296
2013,Dallas Mavericks,DAL,DAL-2013,82,19980,3182,6892,0.462,606,1628,0.372,2576,5264,0.489,1323,1669,0.793,767,2670,3437,1906,648,454,1144,1698,8293
2013,Los Angeles Clippers,LAC,LAC-2013,82,19730,3160,6608,0.478,627,1752,0.358,2533,4856,0.522,1342,1888,0.711,938,2475,3413,1958,784,461,1197,1716,8289
2013,Sacramento Kings,SAC,SAC-2013,82,19830,3086,6904,0.447,610,1681,0.363,2476,5223,0.474,1437,1869,0.769,943,2385,3328,1708,671,342,1199,1717,8219
2013,New York Knicks,NYK,NYK-2013,82,19730,2996,6689,0.448,891,2371,0.376,2105,4318,0.487,1313,1729,0.759,890,2436,3326,1579,672,294,988,1650,8196
2013,Milwaukee Bucks,MIL,MIL-2013,82,19830,3128,7197,0.435,601,1670,0.36,2527,5527,0.457,1251,1700,0.736,1068,2537,3605,1876,685,550,1156,1554,8108
2013,Utah Jazz,UTA,UTA-2013,82,19880,3046,6710,0.454,507,1385,0.366,2539,5325,0.477,1439,1883,0.764,989,2457,3446,1859,690,515,1210,1750,8038
2013,Atlanta Hawks,ATL,ATL-2013,82,19855,3084,6644,0.464,706,1901,0.371,2378,4743,0.501,1158,1619,0.715,758,2593,3351,2007,664,369,1219,1473,8032
2013,Portland Trail Blazers,POR,POR-2013,82,19855,3009,6715,0.448,673,1904,0.353,2336,4811,0.486,1304,1680,0.776,874,2474,3348,1784,538,353,1203,1518,7995
2013,Toronto Raptors,TOR,TOR-2013,82,19980,2979,6685,0.446,571,1665,0.343,2408,5020,0.48,1442,1831,0.788,871,2426,3297,1765,595,392,1124,1836,7971
2013,Brooklyn Nets,BKN,BKN-2013,82,19855,2942,6544,0.45,628,1760,0.357,2314,4784,0.484,1432,1958,0.731,1047,2460,3507,1668,599,391,1206,1500,7944
2013,Cleveland Cavaliers,CLE,CLE-2013,82,19730,2993,6901,0.434,547,1581,0.346,2446,5320,0.46,1380,1826,0.756,1004,2359,3363,1694,647,334,1149,1737,7913
2013,Minnesota Timberwolves,MIN,MIN-2013,82,19730,2943,6702,0.439,450,1475,0.305,2493,5227,0.477,1515,2042,0.742,973,2473,3446,1836,700,387,1214,1509,7851
2013,Boston Celtics,BOS,BOS-2013,81,19840,3001,6459,0.465,498,1390,0.358,2503,5069,0.494,1318,1698,0.776,654,2533,3187,1843,667,365,1181,1717,7818
2013,Phoenix Suns,PHX,PHX-2013,82,19805,3061,6917,0.443,480,1455,0.33,2581,5462,0.473,1203,1618,0.744,959,2454,3413,1855,659,434,1278,1688,7805
2013,Detroit Pistons,DET,DET-2013,82,19805,2979,6638,0.449,513,1440,0.356,2466,5198,0.474,1307,1870,0.699,991,2463,3454,1742,574,400,1241,1623,7778
2013,Orlando Magic,ORL,ORL-2013,82,19780,3093,6904,0.448,506,1537,0.329,2587,5367,0.482,1026,1359,0.755,890,2612,3502,1871,528,358,1191,1591,7718
2013,New Orleans Pelicans,NOP,NOP-2013,82,19780,2955,6589,0.448,535,1474,0.363,2420,5115,0.473,1269,1636,0.776,988,2426,3414,1721,520,440,1193,1673,7714
2013,Indiana Pacers,IND,IND-2013,81,19590,2845,6525,0.436,555,1599,0.347,2290,4926,0.465,1429,1915,0.746,1043,2671,3714,1645,580,513,1227,1623,7674
2013,Charlotte Hornets,CHA,CHA-2013,82,19805,2823,6649,0.425,469,1399,0.335,2354,5250,0.448,1546,2060,0.75,917,2389,3306,1587,591,479,1153,1561,7661
2013,Memphis Grizzlies,MEM,MEM-2013,82,19805,2964,6679,0.444,382,1107,0.345,2582,5572,0.463,1349,1746,0.773,1059,2445,3504,1715,703,436,1144,1660,7659
2013,Washington Wizards,WAS,WAS-2013,82,19855,2910,6693,0.435,545,1495,0.365,2365,5198,0.455,1279,1746,0.733,887,2652,3539,1775,598,376,1238,1681,7644
2013,Chicago Bulls,CHI,CHI-2013,82,19830,2926,6698,0.437,446,1265,0.353,2480,5433,0.456,1343,1738,0.773,1026,2514,3540,1886,588,417,1171,1617,7641
2013,Philadelphia 76ers,PHI,PHI-2013,82,19755,3059,6895,0.444,518,1438,0.36,2541,5457,0.466,1004,1377,0.729,896,2493,3389,1867,609,384,1070,1505,7640
2012,Denver Nuggets,DEN,DEN-2012,66,16040,2572,5404,0.476,435,1311,0.332,2137,4093,0.522,1293,1760,0.735,738,2105,2843,1581,540,330,1015,1297,6872
2012,San Antonio Spurs,SAS,SAS-2012,66,15940,2611,5463,0.478,552,1405,0.393,2059,4058,0.507,1067,1427,0.748,683,2153,2836,1528,490,293,895,1143,6841
2012,Oklahoma City Thunder,OKC,OKC-2012,66,15990,2462,5229,0.471,472,1317,0.358,1990,3912,0.509,1406,1744,0.806,726,2157,2883,1224,498,539,1079,1352,6802
2012,Utah Jazz,UTA,UTA-2012,66,16165,2523,5531,0.456,273,845,0.323,2250,4686,0.48,1258,1668,0.754,861,2055,2916,1439,545,385,936,1441,6577
2012,Milwaukee Bucks,MIL,MIL-2012,66,15865,2502,5652,0.443,436,1265,0.345,2066,4387,0.471,1095,1415,0.774,820,1983,2803,1550,548,335,929,1273,6535
2012,Sacramento Kings,SAC,SAC-2012,66,15915,2490,5712,0.436,411,1301,0.316,2079,4411,0.471,1127,1532,0.736,882,1947,2829,1271,561,323,952,1287,6518
2012,Miami Heat,MIA,MIA-2012,66,16040,2446,5212,0.469,370,1030,0.359,2076,4182,0.496,1238,1598,0.775,686,2060,2746,1317,585,355,1002,1282,6500
2012,Phoenix Suns,PHX,PHX-2012,66,15840,2495,5445,0.458,444,1295,0.343,2051,4150,0.494,1058,1397,0.757,717,2035,2752,1486,431,366,928,1233,6492
2012,Houston Rockets,HOU,HOU-2012,66,16065,2489,5543,0.449,478,1330,0.359,2011,4213,0.477,1018,1301,0.782,769,2014,2783,1404,496,319,955,1347,6474
2012,Minnesota Timberwolves,MIN,MIN-2012,66,15940,2355,5434,0.433,473,1423,0.332,1882,4011,0.469,1281,1662,0.771,797,2089,2886,1290,436,293,1001,1212,6464
2012,New York Knicks,NYK,NYK-2012,66,15940,2365,5335,0.443,517,1538,0.336,1848,3797,0.487,1211,1634,0.741,743,2012,2755,1328,622,276,1056,1391,6458
2012,Golden State Warriors,GSW,GSW-2012,66,15915,2489,5443,0.457,524,1351,0.388,1965,4092,0.48,951,1235,0.77,640,1947,2587,1470,528,362,915,1410,6453
2012,Indiana Pacers,IND,IND-2012,66,15990,2354,5375,0.438,392,1064,0.368,1962,4311,0.455,1349,1724,0.782,826,2070,2896,1228,523,357,925,1430,6449
2012,Los Angeles Clippers,LAC,LAC-2012,66,15965,2439,5366,0.455,514,1441,0.357,1925,3925,0.49,1046,1538,0.68,800,1943,2743,1385,556,315,879,1399,6438
2012,Los Angeles Lakers,LAL,LAL-2012,66,16065,2429,5319,0.457,362,1112,0.326,2067,4207,0.491,1202,1589,0.756,799,2251,3050,1485,390,351,997,1109,6422
2012,Portland Trail Blazers,POR,POR-2012,66,15965,2402,5417,0.443,478,1382,0.346,1924,4035,0.477,1133,1423,0.796,735,1949,2684,1349,528,322,935,1251,6415
2012,Atlanta Hawks,ATL,ATL-2012,66,16165,2429,5348,0.454,492,1330,0.37,1937,4018,0.482,1025,1385,0.74,652,2066,2718,1481,536,303,921,1178,6375
2012,Chicago Bulls,CHI,CHI-2012,66,15940,2467,5462,0.452,419,1117,0.375,2048,4345,0.471,1006,1394,0.722,915,2165,3080,1527,456,388,923,1139,6359
2012,Dallas Mavericks,DAL,DAL-2012,66,16065,2398,5412,0.443,497,1464,0.339,1901,3948,0.482,1029,1334,0.771,665,2157,2822,1380,565,337,926,1226,6322
2012,Memphis Grizzlies,MEM,MEM-2012,66,15940,2425,5422,0.447,277,849,0.326,2148,4573,0.47,1142,1504,0.759,831,1944,2775,1290,631,345,955,1316,6269
2012,Orlando Magic,ORL,ORL-2012,66,15965,2275,5162,0.441,670,1785,0.375,1605,3377,0.475,995,1508,0.66,742,2060,2802,1321,451,275,984,1168,6215
2012,Washington Wizards,WAS,WAS-2012,66,15865,2414,5475,0.441,344,1075,0.32,2070,4400,0.47,1008,1386,0.727,775,1975,2750,1262,527,417,1008,1405,6180
2012,Philadelphia 76ers,PHI,PHI-2012,66,15915,2471,5516,0.448,349,963,0.362,2122,4553,0.466,889,1198,0.742,704,2144,2848,1453,526,340,738,1157,6180
2012,New Jersey Nets,NJN,NJN-2012,66,15890,2262,5320,0.425,507,1481,0.342,1755,3839,0.457,1113,1433,0.777,783,1879,2662,1311,493,260,995,1268,6144
2012,Cleveland Cavaliers,CLE,CLE-2012,66,15965,2261,5360,0.422,440,1273,0.346,1821,4087,0.446,1178,1645,0.716,841,1949,2790,1308,466,262,1017,1317,6140
2012,Boston Celtics,BOS,BOS-2012,66,15940,2341,5086,0.46,363,988,0.367,1978,4098,0.483,1017,1308,0.778,509,2051,2560,1557,498,362,979,1315,6062
2012,Detroit Pistons,DET,DET-2012,66,15965,2291,5232,0.438,317,916,0.346,1974,4316,0.457,1098,1461,0.752,775,1882,2657,1232,460,278,1033,1293,5997
2012,Toronto Raptors,TOR,TOR-2012,66,15965,2268,5154,0.44,365,1075,0.34,1903,4079,0.467,1085,1410,0.77,697,2074,2771,1382,429,321,1001,1532,5986
2012,New Orleans Pelicans,NOP,NOP-2012,66,15940,2300,5103,0.451,259,777,0.333,2041,4326,0.472,1057,1397,0.757,724,1991,2715,1368,488,316,1024,1324,5916
2012,Charlotte Hornets,CHA,CHA-2012,66,15890,2193,5293,0.414,263,892,0.295,1930,4401,0.439,1090,1462,0.746,677,1894,2571,1326,397,361,957,1249,5739
2011,Denver Nuggets,DEN,DEN-2011,82,19705,3145,6613,0.476,662,1704,0.388,2483,4909,0.506,1859,2429,0.765,791,2652,3443,1813,605,352,1157,1719,8811
2011,New York Knicks,NYK,NYK-2011,82,19780,3140,6867,0.457,765,2081,0.368,2375,4786,0.496,1689,2087,0.809,847,2470,3317,1757,625,475,1123,1743,8734
2011,Houston Rockets,HOU,HOU-2011,82,19880,3170,6975,0.454,677,1843,0.367,2493,5132,0.486,1668,2083,0.801,962,2549,3511,1955,581,371,1110,1641,8685
2011,Phoenix Suns,PHX,PHX-2011,82,20005,3219,6844,0.47,701,1857,0.377,2518,4987,0.505,1472,1939,0.759,821,2478,3299,1945,545,357,1169,1666,8611
2011,Oklahoma City Thunder,OKC,OKC-2011,82,20005,3066,6609,0.464,487,1403,0.347,2579,5206,0.495,1977,2401,0.823,903,2604,3507,1672,654,487,1156,1836,8596
2011,San Antonio Spurs,SAS,SAS-2011,82,19780,3148,6628,0.475,685,1727,0.397,2463,4901,0.503,1521,1984,0.767,829,2603,3432,1836,602,372,1101,1556,8502
2011,Golden State Warriors,GSW,GSW-2011,82,19830,3251,7047,0.461,685,1749,0.392,2566,5298,0.484,1290,1695,0.761,955,2370,3325,1847,737,406,1198,1806,8477
2011,Miami Heat,MIA,MIA-2011,82,19780,3031,6301,0.481,547,1479,0.37,2484,4822,0.515,1760,2288,0.769,790,2666,3456,1639,544,430,1142,1674,8369
2011,Los Angeles Lakers,LAL,LAL-2011,82,19830,3128,6757,0.463,524,1487,0.352,2604,5270,0.494,1541,1979,0.779,989,2616,3605,1801,602,422,1073,1555,8321
2011,Minnesota Timberwolves,MIN,MIN-2011,82,19780,3090,7014,0.441,589,1565,0.376,2501,5449,0.459,1519,1977,0.768,1085,2556,3641,1650,592,422,1398,1825,8288
2011,Dallas Mavericks,DAL,DAL-2011,82,19705,3069,6463,0.475,645,1768,0.365,2424,4695,0.516,1437,1850,0.777,780,2618,3398,1954,557,352,1145,1575,8220
2011,Memphis Grizzlies,MEM,MEM-2011,82,19880,3200,6801,0.471,309,926,0.334,2891,5875,0.492,1486,1981,0.75,970,2391,3361,1691,771,441,1145,1705,8195
2011,Indiana Pacers,IND,IND-2011,82,19780,3003,6787,0.442,585,1653,0.354,2418,5134,0.471,1592,2035,0.782,914,2657,3571,1611,584,456,1262,1782,8183
2011,Utah Jazz,UTA,UTA-2011,82,19880,3064,6590,0.465,435,1256,0.346,2629,5334,0.493,1590,2061,0.771,898,2338,3236,1921,629,484,1175,1865,8153
2011,Sacramento Kings,SAC,SAC-2011,82,19855,3134,6979,0.449,428,1277,0.335,2706,5702,0.475,1455,1981,0.734,1071,2526,3597,1675,608,391,1324,1805,8151
2011,Orlando Magic,ORL,ORL-2011,82,19830,2956,6411,0.461,770,2103,0.366,2186,4308,0.507,1453,2101,0.692,864,2679,3543,1636,548,384,1224,1640,8135
2011,Toronto Raptors,TOR,TOR-2011,82,19780,3144,6755,0.465,345,1091,0.316,2799,5664,0.494,1491,1976,0.755,963,2343,3306,1795,581,350,1206,1807,8124
2011,Philadelphia 76ers,PHI,PHI-2011,82,19930,3125,6776,0.461,443,1248,0.355,2682,5528,0.485,1426,1851,0.77,850,2578,3428,1861,621,355,1063,1592,8119
2011,Los Angeles Clippers,LAC,LAC-2011,82,19855,3015,6594,0.457,513,1519,0.338,2502,5075,0.493,1546,2187,0.707,955,2501,3456,1813,585,402,1343,1733,8089
2011,Chicago Bulls,CHI,CHI-2011,82,19830,3042,6587,0.462,511,1415,0.361,2531,5172,0.489,1492,2008,0.743,967,2654,3621,1827,592,468,1161,1639,8087
2011,Washington Wizards,WAS,WAS-2011,82,19930,3048,6888,0.443,392,1182,0.332,2656,5706,0.465,1489,1999,0.745,1013,2374,3387,1592,665,502,1258,1850,7977
2011,Detroit Pistons,DET,DET-2011,82,19880,3056,6647,0.46,472,1256,0.376,2584,5391,0.479,1367,1854,0.737,931,2236,3167,1730,595,328,1067,1629,7951
2011,Boston Celtics,BOS,BOS-2011,82,19780,3023,6219,0.486,408,1119,0.365,2615,5100,0.513,1459,1895,0.77,639,2542,3181,1921,676,344,1195,1678,7913
2011,Portland Trail Blazers,POR,POR-2011,82,19805,2951,6599,0.447,518,1503,0.345,2433,5096,0.477,1476,1835,0.804,996,2230,3226,1736,660,358,1070,1585,7896
2011,Cleveland Cavaliers,CLE,CLE-2011,82,19755,2886,6647,0.434,509,1489,0.342,2377,5158,0.461,1546,2075,0.745,856,2449,3305,1720,544,341,1166,1648,7827
2011,Atlanta Hawks,ATL,ATL-2011,82,19730,2971,6429,0.462,502,1427,0.352,2469,5002,0.494,1346,1728,0.779,762,2460,3222,1802,497,341,1118,1554,7790
2011,New Orleans Pelicans,NOP,NOP-2011,82,19830,2944,6416,0.459,444,1232,0.36,2500,5184,0.482,1452,1897,0.765,824,2468,3292,1691,624,359,1069,1719,7784
2011,New Jersey Nets,NJN,NJN-2011,82,20005,2918,6638,0.44,459,1337,0.343,2459,5301,0.464,1427,1881,0.759,909,2440,3349,1723,458,384,1152,1807,7722
2011,Charlotte Hornets,CHA,CHA-2011,82,19805,2873,6365,0.451,393,1203,0.327,2480,5162,0.48,1511,1999,0.756,848,2444,3292,1728,524,433,1192,1637,7650
2011,Milwaukee Bucks,MIL,MIL-2011,82,19830,2814,6544,0.43,483,1414,0.342,2331,5130,0.454,1423,1881,0.757,862,2480,3342,1545,617,399,1103,1682,7534
2010,Phoenix Suns,PHX,PHX-2010,82,19730,3339,6788,0.492,730,1770,0.412,2609,5018,0.52,1631,2117,0.77,910,2616,3526,1912,479,418,1210,1713,9039
2010,Golden State Warriors,GSW,GSW-2010,82,19730,3329,7094,0.469,633,1687,0.375,2696,5407,0.499,1631,2085,0.782,753,2397,3150,1839,761,340,1204,1886,8922
2010,Denver Nuggets,DEN,DEN-2010,82,19780,3124,6678,0.468,544,1517,0.359,2580,5161,0.5,1937,2508,0.772,889,2505,3394,1719,683,417,1136,1844,8729
2010,Utah Jazz,UTA,UTA-2010,82,19755,3227,6575,0.491,439,1207,0.364,2788,5368,0.519,1654,2233,0.741,872,2588,3460,2187,675,400,1246,1859,8547
2010,Toronto Raptors,TOR,TOR-2010,82,19780,3199,6631,0.482,518,1397,0.371,2681,5234,0.512,1618,2118,0.764,806,2507,3313,1804,469,384,1100,1819,8534
2010,Orlando Magic,ORL,ORL-2010,82,19730,3005,6394,0.47,841,2241,0.375,2164,4153,0.521,1575,2176,0.724,810,2736,3546,1615,512,456,1155,1629,8426
2010,Memphis Grizzlies,MEM,MEM-2010,82,19905,3223,6875,0.469,344,1020,0.337,2879,5855,0.492,1614,2202,0.733,1070,2496,3566,1543,645,399,1248,1655,8404
2010,Houston Rockets,HOU,HOU-2010,82,19905,3094,6923,0.447,646,1838,0.351,2448,5085,0.481,1561,2022,0.772,971,2471,3442,1790,583,318,1188,1712,8395
2010,Cleveland Cavaliers,CLE,CLE-2010,82,19780,3101,6391,0.485,602,1582,0.381,2499,4809,0.52,1569,2180,0.72,791,2692,3483,1835,564,425,1137,1591,8373
2010,New York Knicks,NYK,NYK-2010,82,19880,3127,6876,0.455,743,2145,0.346,2384,4731,0.504,1376,1759,0.782,836,2477,3313,1772,586,305,1148,1638,8373
2010,Dallas Mavericks,DAL,DAL-2010,82,19880,3140,6760,0.464,558,1498,0.372,2582,5262,0.491,1526,1870,0.816,834,2586,3420,1917,624,449,1059,1563,8364
2010,Los Angeles Lakers,LAL,LAL-2010,82,19830,3144,6875,0.457,532,1562,0.341,2612,5313,0.492,1519,1985,0.765,973,2662,3635,1730,612,400,1096,1592,8339
2010,Atlanta Hawks,ATL,ATL-2010,82,19855,3181,6801,0.468,524,1455,0.36,2657,5346,0.497,1452,1914,0.759,969,2451,3420,1789,592,413,980,1632,8338
2010,Oklahoma City Thunder,OKC,OKC-2010,82,19805,3063,6629,0.462,418,1229,0.34,2645,5400,0.49,1778,2210,0.805,960,2607,3567,1639,654,481,1227,1743,8322
2010,San Antonio Spurs,SAS,SAS-2010,82,19780,3150,6659,0.473,554,1547,0.358,2596,5112,0.508,1458,1969,0.74,887,2621,3508,1829,516,381,1116,1669,8312
2010,Indiana Pacers,IND,IND-2010,82,19705,3020,6823,0.443,659,1896,0.348,2361,4927,0.479,1564,2019,0.775,785,2618,3403,1730,585,439,1232,1848,8263
2010,New Orleans Pelicans,NOP,NOP-2010,82,19830,3178,6842,0.464,571,1572,0.363,2607,5270,0.495,1293,1661,0.778,852,2450,3302,1828,625,300,1103,1606,8220
2010,Sacramento Kings,SAC,SAC-2010,82,19880,3144,6895,0.456,482,1383,0.349,2662,5512,0.483,1430,1969,0.726,977,2518,3495,1679,564,366,1226,1827,8200
2010,Boston Celtics,BOS,BOS-2010,82,19780,3039,6294,0.483,499,1433,0.348,2540,4861,0.523,1559,2090,0.746,716,2449,3165,1930,701,402,1219,1816,8136
2010,Minnesota Timberwolves,MIN,MIN-2010,82,19780,3106,6923,0.449,403,1181,0.341,2703,5742,0.471,1436,1926,0.746,962,2556,3518,1626,597,306,1333,1699,8051
2010,Portland Trail Blazers,POR,POR-2010,82,19855,2974,6453,0.461,491,1388,0.354,2483,5065,0.49,1606,2033,0.79,913,2383,3296,1674,523,350,1012,1715,8045
2010,Philadelphia 76ers,PHI,PHI-2010,82,19805,3087,6706,0.46,474,1381,0.343,2613,5325,0.491,1366,1808,0.756,941,2421,3362,1723,667,439,1192,1677,8014
2010,Milwaukee Bucks,MIL,MIL-2010,82,19980,3050,6998,0.436,645,1813,0.356,2405,5185,0.464,1264,1675,0.755,965,2560,3525,1740,580,385,1085,1823,8009
2010,Chicago Bulls,CHI,CHI-2010,82,19905,3081,6825,0.451,352,1066,0.33,2729,5759,0.474,1479,1962,0.754,937,2715,3652,1704,531,478,1175,1648,7993
2010,Miami Heat,MIA,MIA-2010,82,19880,2984,6518,0.458,494,1426,0.346,2490,5092,0.489,1452,1931,0.752,875,2553,3428,1548,605,457,1079,1710,7914
2010,Washington Wizards,WAS,WAS-2010,82,19830,3008,6700,0.449,432,1225,0.353,2576,5475,0.471,1444,1895,0.762,966,2458,3424,1557,493,421,1219,1752,7892
2010,Los Angeles Clippers,LAC,LAC-2010,82,19705,3002,6601,0.455,483,1457,0.332,2519,5144,0.49,1362,1867,0.73,927,2502,3429,1810,532,466,1285,1581,7849
2010,Charlotte Hornets,CHA,CHA-2010,82,19880,2858,6306,0.453,460,1331,0.346,2398,4975,0.482,1637,2180,0.751,858,2490,3348,1658,632,446,1290,1597,7813
2010,Detroit Pistons,DET,DET-2010,82,19780,2940,6602,0.445,374,1190,0.314,2566,5412,0.474,1455,1998,0.728,1053,2242,3295,1591,596,313,1100,1822,7709
2010,New Jersey Nets,NJN,NJN-2010,82,19780,2813,6554,0.429,377,1185,0.318,2436,5369,0.454,1572,2015,0.78,897,2358,3255,1540,573,393,1182,1643,7575
2009,Phoenix Suns,PHX,PHX-2009,82,19755,3373,6695,0.504,553,1445,0.383,2820,5250,0.537,1675,2251,0.744,900,2520,3420,1905,589,420,1288,1691,8974
2009,Golden State Warriors,GSW,GSW-2009,82,19880,3231,7055,0.458,550,1475,0.373,2681,5580,0.48,1893,2392,0.791,953,2492,3445,1711,638,527,1201,1842,8905
2009,Los Angeles Lakers,LAL,LAL-2009,82,19780,3307,6981,0.474,547,1516,0.361,2760,5465,0.505,1607,2087,0.77,1015,2587,3602,1908,718,420,1103,1698,8768
2009,New York Knicks,NYK,NYK-2009,82,19805,3157,7091,0.445,823,2284,0.36,2334,4807,0.486,1490,1900,0.784,911,2545,3456,1738,610,204,1174,1672,8627
2009,Indiana Pacers,IND,IND-2009,82,19830,3220,7080,0.455,652,1725,0.378,2568,5355,0.48,1525,1890,0.807,924,2661,3585,1775,573,434,1189,1895,8617
2009,Denver Nuggets,DEN,DEN-2009,82,19730,3058,6510,0.47,548,1477,0.371,2510,5033,0.499,1891,2487,0.76,905,2507,3412,1820,710,492,1257,1874,8555
2009,Utah Jazz,UTA,UTA-2009,82,19880,3143,6623,0.475,392,1122,0.349,2751,5501,0.5,1814,2352,0.771,940,2423,3363,2024,719,374,1210,1830,8492
2009,Chicago Bulls,CHI,CHI-2009,82,19930,3126,6846,0.457,493,1293,0.381,2633,5553,0.474,1633,2052,0.796,970,2481,3451,1732,615,453,1192,1709,8378
2009,Dallas Mavericks,DAL,DAL-2009,82,19805,3128,6770,0.462,571,1632,0.35,2557,5138,0.498,1516,1852,0.819,909,2595,3504,1779,591,429,1043,1600,8343
2009,Orlando Magic,ORL,ORL-2009,82,19730,2929,6416,0.457,817,2147,0.381,2112,4269,0.495,1611,2253,0.715,819,2728,3547,1593,570,439,1142,1664,8286
2009,Boston Celtics,BOS,BOS-2009,82,19880,3075,6333,0.486,538,1355,0.397,2537,4978,0.51,1587,2075,0.765,869,2586,3455,1862,621,387,1280,1897,8275
2009,Sacramento Kings,SAC,SAC-2009,82,19905,2990,6685,0.447,586,1594,0.368,2404,5091,0.472,1682,2107,0.798,840,2366,3206,1619,569,349,1266,1910,8248
2009,Cleveland Cavaliers,CLE,CLE-2009,82,19780,3022,6454,0.468,656,1670,0.393,2366,4784,0.495,1523,2012,0.757,886,2574,3460,1663,593,435,1045,1663,8223
2009,Portland Trail Blazers,POR,POR-2009,82,19830,3018,6494,0.465,596,1555,0.383,2422,4939,0.49,1521,1988,0.765,1060,2360,3420,1667,550,402,1055,1671,8153
2009,Milwaukee Bucks,MIL,MIL-2009,82,19780,3009,6755,0.445,511,1408,0.363,2498,5347,0.467,1613,2067,0.78,973,2367,3340,1802,609,308,1154,1986,8142
2009,Toronto Raptors,TOR,TOR-2009,82,19805,3054,6673,0.458,479,1289,0.372,2575,5384,0.478,1534,1861,0.824,802,2513,3315,1835,523,390,1098,1593,8121
2009,Houston Rockets,HOU,HOU-2009,82,19805,2959,6526,0.453,621,1656,0.375,2338,4870,0.48,1531,1903,0.805,862,2662,3524,1662,548,355,1158,1553,8070
2009,Miami Heat,MIA,MIA-2009,82,19955,3034,6646,0.457,582,1631,0.357,2452,5015,0.489,1411,1871,0.754,828,2411,3239,1671,651,451,1026,1696,8061
2009,Atlanta Hawks,ATL,ATL-2009,82,19705,2956,6451,0.458,597,1633,0.366,2359,4818,0.49,1537,2085,0.737,870,2412,3282,1657,603,376,1048,1610,8046
2009,New Jersey Nets,NJN,NJN-2009,82,19830,2925,6536,0.448,652,1735,0.376,2273,4801,0.473,1542,1980,0.779,850,2415,3265,1636,559,391,1075,1838,8044
2009,Minnesota Timberwolves,MIN,MIN-2009,82,19805,2986,6766,0.441,543,1539,0.353,2443,5227,0.467,1504,1957,0.769,975,2442,3417,1674,512,322,1165,1785,8019
2009,Philadelphia 76ers,PHI,PHI-2009,82,19755,2997,6532,0.459,341,1072,0.318,2656,5460,0.486,1652,2216,0.745,1039,2336,3375,1647,658,415,1157,1650,7987
2009,San Antonio Spurs,SAS,SAS-2009,82,19905,3042,6534,0.466,625,1620,0.386,2417,4914,0.492,1249,1641,0.761,728,2638,3366,1736,474,329,963,1546,7958
2009,Oklahoma City Thunder,OKC,OKC-2009,82,19805,2999,6716,0.447,328,949,0.346,2671,5767,0.463,1626,2069,0.786,999,2497,3496,1663,608,371,1330,1655,7952
2009,Washington Wizards,WAS,WAS-2009,82,19705,2994,6655,0.45,395,1198,0.33,2599,5457,0.476,1494,1948,0.767,956,2330,3286,1641,619,365,1146,1679,7877
2009,New Orleans Pelicans,NOP,NOP-2009,82,19755,2911,6366,0.457,556,1526,0.364,2355,4840,0.487,1479,1833,0.807,802,2453,3255,1609,593,338,1029,1665,7857
2009,Los Angeles Clippers,LAC,LAC-2009,82,19880,2955,6696,0.441,535,1513,0.354,2420,5183,0.467,1354,1839,0.736,890,2377,3267,1723,572,482,1221,1650,7799
2009,Detroit Pistons,DET,DET-2009,82,19905,2981,6559,0.454,377,1079,0.349,2604,5480,0.475,1388,1849,0.751,949,2448,3397,1689,493,377,973,1712,7727
2009,Memphis Grizzlies,MEM,MEM-2009,82,19805,2865,6311,0.454,398,1106,0.36,2467,5205,0.474,1570,2077,0.756,847,2337,3184,1423,615,385,1252,1777,7698
2009,Charlotte Hornets,CHA,CHA-2009,82,19930,2866,6299,0.455,490,1339,0.366,2376,4960,0.479,1455,1965,0.74,886,2366,3252,1741,580,397,1279,1754,7677
2008,Golden State Warriors,GSW,GSW-2008,82,19780,3403,7406,0.459,761,2185,0.348,2642,5221,0.506,1538,2044,0.752,1045,2496,3541,1833,744,377,1082,1875,9105
2008,Denver Nuggets,DEN,DEN-2008,82,19855,3307,7038,0.47,569,1605,0.355,2738,5433,0.504,1891,2519,0.751,918,2698,3616,2024,752,551,1203,1731,9074
2008,Phoenix Suns,PHX,PHX-2008,82,19780,3392,6782,0.5,694,1764,0.393,2698,5018,0.538,1548,1977,0.783,720,2683,3403,2188,532,518,1184,1633,9026
2008,Los Angeles Lakers,LAL,LAL-2008,82,19780,3248,6818,0.476,662,1751,0.378,2586,5067,0.51,1746,2270,0.769,898,2722,3620,2003,654,438,1156,1691,8904
2008,Utah Jazz,UTA,UTA-2008,82,19705,3279,6592,0.497,407,1095,0.372,2872,5497,0.522,1745,2298,0.759,942,2410,3352,2165,717,355,1200,1970,8710
2008,Orlando Magic,ORL,ORL-2008,82,19780,3058,6446,0.474,801,2074,0.386,2257,4372,0.516,1650,2288,0.721,768,2677,3445,1706,520,333,1173,1688,8567
2008,Indiana Pacers,IND,IND-2008,82,19755,3102,6993,0.444,755,2021,0.374,2347,4972,0.472,1568,2042,0.768,904,2633,3537,1864,623,412,1236,1921,8527
2008,Sacramento Kings,SAC,SAC-2008,82,19830,3043,6558,0.464,510,1367,0.373,2533,5191,0.488,1812,2272,0.798,829,2456,3285,1567,651,334,1317,1839,8408
2008,New Orleans Pelicans,NOP,NOP-2008,82,19805,3164,6796,0.466,630,1621,0.389,2534,5175,0.49,1312,1707,0.769,937,2494,3431,1785,637,321,974,1531,8270
2008,Memphis Grizzlies,MEM,MEM-2008,82,19805,3060,6737,0.454,620,1779,0.349,2440,4958,0.492,1517,2097,0.723,848,2567,3415,1574,503,386,1251,1592,8257
2008,Boston Celtics,BOS,BOS-2008,82,19755,2986,6286,0.475,596,1564,0.381,2390,4722,0.506,1677,2176,0.771,830,2615,3445,1833,696,379,1246,1864,8245
2008,Dallas Mavericks,DAL,DAL-2008,82,19730,3025,6515,0.464,494,1403,0.352,2531,5112,0.495,1690,2075,0.814,883,2643,3526,1720,490,402,1037,1786,8234
2008,Toronto Raptors,TOR,TOR-2008,82,19830,3148,6726,0.468,572,1459,0.392,2576,5267,0.489,1347,1658,0.812,790,2496,3286,1953,570,336,959,1596,8215
2008,Washington Wizards,WAS,WAS-2008,82,19905,2986,6695,0.446,575,1614,0.356,2411,5081,0.475,1557,1991,0.782,1007,2404,3411,1607,632,391,1082,1606,8104
2008,Atlanta Hawks,ATL,ATL-2008,82,19855,2975,6552,0.454,384,1078,0.356,2591,5474,0.473,1720,2227,0.772,1008,2454,3462,1804,600,448,1223,1673,8054
2008,Oklahoma City Thunder,OKC,OKC-2008,82,19830,3125,7032,0.444,313,939,0.333,2812,6093,0.462,1436,1866,0.77,971,2688,3659,1748,531,400,1310,1680,7999
2008,Detroit Pistons,DET,DET-2008,82,19730,2999,6551,0.458,487,1330,0.366,2512,5221,0.481,1507,1965,0.767,974,2423,3397,1831,583,472,956,1688,7992
2008,Chicago Bulls,CHI,CHI-2008,82,19805,2987,6861,0.435,474,1305,0.363,2513,5556,0.452,1533,2029,0.756,1050,2478,3528,1811,635,429,1197,1784,7981
2008,Charlotte Hornets,CHA,CHA-2008,82,19880,2960,6554,0.452,529,1443,0.367,2431,5111,0.476,1510,2115,0.714,892,2440,3332,1748,614,402,1204,1777,7959
2008,Milwaukee Bucks,MIL,MIL-2008,82,19855,3026,6745,0.449,452,1313,0.344,2574,5432,0.474,1452,1980,0.733,1055,2363,3418,1760,544,361,1210,1748,7956
2008,New York Knicks,NYK,NYK-2008,82,19880,2967,6757,0.439,490,1454,0.337,2477,5303,0.467,1524,2095,0.727,1029,2457,3486,1530,521,213,1187,1761,7948
2008,Houston Rockets,HOU,HOU-2008,82,19730,3003,6698,0.448,583,1707,0.342,2420,4991,0.485,1342,1848,0.726,1002,2659,3661,1757,598,420,1125,1609,7931
2008,Philadelphia 76ers,PHI,PHI-2008,82,19755,3056,6648,0.46,302,952,0.317,2754,5696,0.483,1509,2137,0.706,1067,2370,3437,1673,712,400,1172,1620,7923
2008,Cleveland Cavaliers,CLE,CLE-2008,82,19855,2937,6697,0.439,552,1544,0.358,2385,5153,0.463,1477,2061,0.717,1092,2563,3655,1640,579,427,1145,1712,7903
2008,New Jersey Nets,NJN,NJN-2008,82,19830,2856,6450,0.443,498,1430,0.348,2358,5020,0.47,1647,2237,0.736,913,2520,3433,1925,521,390,1229,1855,7857
2008,Minnesota Timberwolves,MIN,MIN-2008,82,19730,3076,6817,0.451,441,1259,0.35,2635,5558,0.474,1246,1693,0.736,964,2428,3392,1630,616,306,1188,1885,7839
2008,San Antonio Spurs,SAS,SAS-2008,82,19730,2938,6424,0.457,594,1610,0.369,2344,4814,0.487,1350,1774,0.761,771,2612,3383,1718,521,337,1035,1537,7820
2008,Portland Trail Blazers,POR,POR-2008,82,19905,2935,6546,0.448,538,1426,0.377,2397,5120,0.468,1412,1841,0.767,901,2438,3339,1733,455,360,1056,1642,7820
2008,Los Angeles Clippers,LAC,LAC-2008,82,19805,2820,6445,0.438,350,1079,0.324,2470,5366,0.46,1702,2178,0.781,800,2491,3291,1732,557,398,1180,1745,7692
2008,Miami Heat,MIA,MIA-2008,82,19830,2808,6336,0.443,491,1373,0.358,2317,4963,0.467,1384,1903,0.727,743,2342,3085,1644,589,355,1202,1670,7491
2007,Phoenix Suns,PHX,PHX-2007,82,19905,3388,6855,0.494,785,1965,0.399,2603,4890,0.532,1476,1827,0.808,737,2583,3320,2122,553,394,1189,1659,9037
2007,Golden State Warriors,GSW,GSW-2007,82,19755,3261,7048,0.463,700,1967,0.356,2561,5081,0.504,1515,2113,0.717,940,2456,3396,1950,750,466,1309,1933,8737
2007,Denver Nuggets,DEN,DEN-2007,82,19780,3164,6805,0.465,484,1440,0.336,2680,5365,0.5,1827,2449,0.746,1001,2558,3559,1920,678,435,1352,1756,8639
2007,Washington Wizards,WAS,WAS-2007,82,19830,3070,6820,0.45,561,1614,0.348,2509,5206,0.482,1855,2425,0.765,998,2379,3377,1660,635,375,1133,1823,8556
2007,Los Angeles Lakers,LAL,LAL-2007,82,20030,3103,6664,0.466,608,1724,0.353,2495,4940,0.505,1660,2221,0.747,886,2495,3381,1850,600,421,1273,1889,8474
2007,Memphis Grizzlies,MEM,MEM-2007,82,19980,2998,6448,0.465,500,1362,0.367,2498,5086,0.491,1835,2410,0.761,866,2375,3241,1680,564,407,1343,1827,8331
2007,Utah Jazz,UTA,UTA-2007,82,19805,3069,6471,0.474,354,1056,0.335,2715,5415,0.501,1830,2462,0.743,1030,2456,3486,2024,577,339,1277,2067,8322
2007,Sacramento Kings,SAC,SAC-2007,82,19805,2941,6532,0.45,530,1513,0.35,2411,5019,0.48,1891,2473,0.765,797,2396,3193,1665,671,265,1194,1792,8303
2007,Dallas Mavericks,DAL,DAL-2007,82,19755,3010,6442,0.467,535,1404,0.381,2475,5038,0.491,1646,2045,0.805,920,2515,3435,1632,560,408,1140,1837,8201
2007,Milwaukee Bucks,MIL,MIL-2007,82,19855,3121,6714,0.465,524,1472,0.356,2597,5242,0.495,1406,1919,0.733,941,2272,3213,1771,587,224,1240,1821,8172
2007,Toronto Raptors,TOR,TOR-2007,82,19755,3032,6547,0.463,531,1464,0.363,2501,5083,0.492,1562,1982,0.788,755,2480,3235,1822,581,321,1104,1672,8157
2007,Seattle SuperSonics,SEA,SEA-2007,82,19830,3047,6628,0.46,525,1451,0.362,2522,5177,0.487,1511,1911,0.791,928,2322,3250,1695,631,301,1268,1801,8130
2007,Chicago Bulls,CHI,CHI-2007,82,19780,3046,6663,0.457,480,1237,0.388,2566,5426,0.473,1528,2083,0.734,984,2597,3581,1832,639,445,1310,1908,8100
2007,San Antonio Spurs,SAS,SAS-2007,82,19780,2999,6328,0.474,595,1561,0.381,2404,4767,0.504,1486,1980,0.751,761,2577,3338,1814,587,417,1137,1588,8079
2007,New Jersey Nets,NJN,NJN-2007,82,19880,2913,6379,0.457,609,1676,0.363,2304,4703,0.49,1566,2153,0.727,822,2525,3347,1962,499,273,1212,1869,8001
2007,New York Knicks,NYK,NYK-2007,82,20005,2903,6356,0.457,474,1370,0.346,2429,4986,0.487,1714,2396,0.715,1032,2516,3548,1532,543,260,1405,1932,7994
2007,Houston Rockets,HOU,HOU-2007,82,19855,2906,6528,0.445,705,1893,0.372,2201,4635,0.475,1436,1906,0.753,880,2673,3553,1704,583,337,1162,1710,7953
2007,Charlotte Hornets,CHA,CHA-2007,82,20005,2960,6643,0.446,457,1280,0.357,2503,5363,0.467,1568,2136,0.734,920,2346,3266,1836,638,369,1224,1985,7945
2007,Cleveland Cavaliers,CLE,CLE-2007,82,19880,2978,6658,0.447,494,1404,0.352,2484,5254,0.473,1484,2133,0.696,1039,2529,3568,1708,625,353,1177,1781,7934
2007,Minnesota Timberwolves,MIN,MIN-2007,82,20005,2997,6503,0.461,384,1089,0.353,2613,5414,0.483,1499,1892,0.792,819,2474,3293,1848,532,325,1278,1758,7877
2007,Detroit Pistons,DET,DET-2007,82,19880,2942,6484,0.454,449,1305,0.344,2493,5179,0.481,1539,1988,0.774,948,2374,3322,1768,583,472,1001,1672,7872
2007,Boston Celtics,BOS,BOS-2007,82,19855,2858,6454,0.443,471,1283,0.367,2387,5171,0.462,1670,2178,0.767,918,2391,3309,1630,589,382,1350,1971,7857
2007,Los Angeles Clippers,LAC,LAC-2007,82,19730,2880,6318,0.456,314,903,0.348,2566,5415,0.474,1769,2245,0.788,888,2484,3372,1762,596,472,1239,1858,7843
2007,Indiana Pacers,IND,IND-2007,82,19780,2872,6561,0.438,481,1389,0.346,2391,5172,0.462,1615,2125,0.76,990,2441,3431,1680,599,447,1335,1912,7840
2007,New Orleans Pelicans,NOP,NOP-2007,82,19880,2971,6674,0.445,455,1256,0.362,2516,5418,0.464,1436,1941,0.74,1025,2512,3537,1537,522,347,1187,1620,7833
2007,Philadelphia 76ers,PHI,PHI-2007,82,19880,2932,6408,0.458,284,823,0.345,2648,5585,0.474,1637,2135,0.767,899,2353,3252,1669,590,390,1258,1671,7785
2007,Orlando Magic,ORL,ORL-2007,82,19780,2875,6090,0.472,342,962,0.356,2533,5128,0.494,1679,2393,0.702,920,2418,3338,1525,565,416,1392,1904,7771
2007,Miami Heat,MIA,MIA-2007,82,19855,2919,6288,0.464,528,1539,0.343,2391,4749,0.503,1393,2019,0.69,817,2526,3343,1681,566,442,1201,1749,7759
2007,Portland Trail Blazers,POR,POR-2007,82,19955,2874,6392,0.45,426,1232,0.346,2448,5160,0.474,1543,2006,0.769,923,2299,3222,1513,555,380,1236,1931,7717
2007,Atlanta Hawks,ATL,ATL-2007,82,19880,2831,6372,0.444,341,1038,0.329,2490,5334,0.467,1677,2203,0.761,976,2312,3288,1573,609,446,1306,1970,7680
2006,Phoenix Suns,PHX,PHX-2006,82,19955,3430,7167,0.479,837,2097,0.399,2593,5070,0.511,1189,1475,0.806,778,2650,3428,2179,549,412,1088,1683,8886
2006,Seattle SuperSonics,SEA,SEA-2006,82,19830,3077,6711,0.459,605,1631,0.371,2472,5080,0.487,1652,2104,0.785,1013,2233,3246,1696,622,306,1208,1933,8411
2006,Washington Wizards,WAS,WAS-2006,82,19830,2975,6656,0.447,497,1394,0.357,2478,5262,0.471,1889,2496,0.757,1035,2344,3379,1523,658,339,1143,1855,8336
2006,Toronto Raptors,TOR,TOR-2006,82,19955,3013,6639,0.454,608,1620,0.375,2405,5019,0.479,1653,2089,0.791,864,2291,3155,1593,529,272,1071,1965,8287
2006,Denver Nuggets,DEN,DEN-2006,82,19930,3078,6672,0.461,350,1076,0.325,2728,5596,0.487,1721,2312,0.744,903,2486,3389,1921,698,463,1216,1863,8227
2006,Miami Heat,MIA,MIA-2006,82,19755,3039,6355,0.478,497,1441,0.345,2542,4914,0.517,1616,2310,0.7,858,2675,3533,1692,522,442,1186,1871,8191
2006,Los Angeles Lakers,LAL,LAL-2006,82,19855,2992,6607,0.453,552,1583,0.349,2440,5024,0.486,1618,2172,0.745,970,2488,3458,1734,628,350,1143,1894,8154
2006,Philadelphia 76ers,PHI,PHI-2006,82,19905,3001,6546,0.458,375,1031,0.364,2626,5515,0.476,1770,2330,0.76,873,2425,3298,1653,651,404,1159,1712,8147
2006,Dallas Mavericks,DAL,DAL-2006,82,19880,2948,6375,0.462,416,1113,0.374,2532,5262,0.481,1818,2322,0.783,1030,2431,3461,1473,593,488,1112,1834,8130
2006,Sacramento Kings,SAC,SAC-2006,82,19830,2954,6500,0.454,494,1408,0.351,2460,5092,0.483,1704,2173,0.784,852,2473,3325,1825,608,299,1199,1672,8106
2006,Golden State Warriors,GSW,GSW-2006,82,19830,2939,6785,0.433,625,1832,0.341,2314,4953,0.467,1573,2190,0.718,980,2485,3465,1694,604,357,1156,1941,8076
2006,Boston Celtics,BOS,BOS-2006,82,19880,2951,6322,0.467,467,1290,0.362,2484,5032,0.494,1664,2204,0.755,813,2432,3245,1716,578,422,1359,2033,8033
2006,Milwaukee Bucks,MIL,MIL-2006,82,19855,2976,6566,0.453,507,1335,0.38,2469,5231,0.472,1561,2115,0.738,929,2448,3377,1769,597,270,1197,1902,8020
2006,Chicago Bulls,CHI,CHI-2006,82,19905,3004,6737,0.446,560,1477,0.379,2444,5260,0.465,1452,1967,0.738,906,2602,3508,1804,508,345,1224,2038,8020
2006,Cleveland Cavaliers,CLE,CLE-2006,82,19830,2908,6412,0.454,497,1465,0.339,2411,4947,0.487,1689,2318,0.729,959,2511,3470,1560,567,392,1137,1733,8002
2006,Atlanta Hawks,ATL,ATL-2006,82,19880,2946,6496,0.454,424,1154,0.367,2522,5342,0.472,1656,2207,0.75,1069,2232,3301,1625,587,394,1284,2054,7972
2006,Los Angeles Clippers,LAC,LAC-2006,82,19805,2993,6443,0.465,290,843,0.344,2703,5600,0.483,1694,2142,0.791,828,2704,3532,1708,534,503,1185,1872,7970
2006,Charlotte Hornets,CHA,CHA-2006,82,19905,2961,6843,0.433,428,1261,0.339,2533,5582,0.454,1593,2186,0.729,990,2270,3260,1717,822,354,1167,1960,7943
2006,Detroit Pistons,DET,DET-2006,82,19830,2983,6558,0.455,557,1451,0.384,2426,5107,0.475,1418,1950,0.727,975,2347,3322,1971,580,490,931,1513,7941
2006,New York Knicks,NYK,NYK-2006,82,19930,2822,6206,0.455,320,884,0.362,2502,5322,0.47,1878,2587,0.726,1034,2360,3394,1468,555,271,1449,2157,7842
2006,San Antonio Spurs,SAS,SAS-2006,82,19805,2993,6342,0.472,524,1362,0.385,2469,4980,0.496,1327,1891,0.702,851,2548,3399,1717,543,467,1126,1714,7837
2006,Orlando Magic,ORL,ORL-2006,82,19905,2911,6167,0.472,299,796,0.376,2612,5371,0.486,1663,2277,0.73,892,2402,3294,1495,532,362,1240,1908,7784
2006,Indiana Pacers,IND,IND-2006,82,19730,2786,6274,0.444,536,1536,0.349,2250,4738,0.475,1591,2158,0.737,898,2559,3457,1631,598,409,1254,1821,7699
2006,New Jersey Nets,NJN,NJN-2006,82,19780,2778,6317,0.44,477,1447,0.33,2301,4870,0.472,1658,2187,0.758,822,2539,3361,1884,558,278,1119,1903,7691
2006,New Orleans Pelicans,NOP,NOP-2006,82,19805,2831,6428,0.44,300,885,0.339,2531,5543,0.457,1649,2176,0.758,918,2379,3297,1519,611,311,1095,1786,7611
2006,Utah Jazz,UTA,UTA-2006,82,19880,2744,6207,0.442,311,925,0.336,2433,5282,0.461,1774,2466,0.719,1071,2380,3451,1772,524,492,1290,2032,7573
2006,Memphis Grizzlies,MEM,MEM-2006,82,19855,2746,6125,0.448,590,1578,0.374,2156,4547,0.474,1476,2077,0.711,834,2379,3213,1586,600,442,1134,1757,7558
2006,Minnesota Timberwolves,MIN,MIN-2006,82,19855,2888,6340,0.456,310,942,0.329,2578,5398,0.478,1436,1895,0.758,811,2422,3233,1716,559,471,1189,1889,7522
2006,Houston Rockets,HOU,HOU-2006,82,19830,2708,6252,0.433,469,1414,0.332,2239,4838,0.463,1502,1980,0.759,849,2565,3414,1580,588,320,1193,1863,7387
2006,Portland Trail Blazers,POR,POR-2006,82,19730,2791,6267,0.445,364,1042,0.349,2427,5225,0.464,1339,1944,0.689,886,2203,3089,1490,529,435,1205,1828,7285
2005,Phoenix Suns,PHX,PHX-2005,82,19780,3351,7018,0.477,796,2026,0.393,2555,4992,0.512,1556,2080,0.748,967,2652,3619,1927,572,453,1125,1563,9054
2005,Sacramento Kings,SAC,SAC-2005,82,19855,3203,6978,0.459,522,1396,0.374,2681,5582,0.48,1577,2004,0.787,1023,2455,3478,2005,674,316,1073,1685,8505
2005,Dallas Mavericks,DAL,DAL-2005,82,19730,3058,6691,0.457,463,1273,0.364,2595,5418,0.479,1826,2314,0.789,990,2530,3520,1610,708,461,1102,1827,8405
2005,Miami Heat,MIA,MIA-2005,82,19980,3097,6368,0.486,475,1260,0.377,2622,5108,0.513,1658,2466,0.672,887,2639,3526,1790,528,474,1127,1814,8327
2005,Boston Celtics,BOS,BOS-2005,82,19880,3046,6511,0.468,437,1252,0.349,2609,5259,0.496,1775,2323,0.764,909,2438,3347,1810,667,423,1297,2000,8304
2005,Washington Wizards,WAS,WAS-2005,82,19780,2966,6794,0.437,514,1498,0.343,2452,5296,0.463,1795,2476,0.725,1133,2374,3507,1563,716,347,1172,1807,8241
2005,Toronto Raptors,TOR,TOR-2005,82,19805,2952,6656,0.444,648,1681,0.385,2304,4975,0.463,1626,2101,0.774,844,2444,3288,1670,621,317,1087,1876,8178
2005,Denver Nuggets,DEN,DEN-2005,82,19755,3038,6615,0.459,320,940,0.34,2718,5675,0.479,1765,2313,0.763,967,2473,3440,1958,750,489,1224,1878,8161
2005,Orlando Magic,ORL,ORL-2005,82,19705,3034,6679,0.454,320,916,0.349,2714,5763,0.471,1772,2335,0.759,1038,2544,3582,1583,633,441,1322,1937,8160
2005,Philadelphia 76ers,PHI,PHI-2005,82,19855,2946,6736,0.437,505,1453,0.348,2441,5283,0.462,1731,2194,0.789,909,2536,3445,1710,756,321,1274,1878,8128
2005,Seattle SuperSonics,SEA,SEA-2005,82,19755,2882,6498,0.444,666,1824,0.365,2216,4674,0.474,1683,2131,0.79,1041,2311,3352,1487,553,338,1113,1944,8113
2005,Los Angeles Lakers,LAL,LAL-2005,82,19780,2895,6629,0.437,644,1813,0.355,2251,4816,0.467,1661,2137,0.777,1028,2511,3539,1672,508,344,1176,1794,8095
2005,Golden State Warriors,GSW,GSW-2005,82,19905,3029,7039,0.43,624,1774,0.352,2405,5265,0.457,1412,1955,0.722,1069,2436,3505,1811,642,420,1112,1833,8094
2005,New York Knicks,NYK,NYK-2005,82,19880,2978,6599,0.451,441,1240,0.356,2537,5359,0.473,1580,2060,0.767,965,2393,3358,1665,629,260,1204,1942,7977
2005,Milwaukee Bucks,MIL,MIL-2005,82,19780,2964,6580,0.45,325,925,0.351,2639,5655,0.467,1720,2229,0.772,985,2405,3390,1720,529,289,1132,1797,7973
2005,Minnesota Timberwolves,MIN,MIN-2005,82,19755,3045,6629,0.459,395,1145,0.345,2650,5484,0.483,1449,1820,0.796,947,2580,3527,1918,460,447,1079,1774,7934
2005,Cleveland Cavaliers,CLE,CLE-2005,82,19855,2990,6687,0.447,300,904,0.332,2690,5783,0.465,1634,2174,0.752,1117,2352,3469,1851,654,461,1141,1850,7914
2005,San Antonio Spurs,SAS,SAS-2005,82,19805,2923,6450,0.453,507,1395,0.363,2416,5055,0.478,1535,2120,0.724,987,2489,3476,1771,613,543,1126,1717,7888
2005,Los Angeles Clippers,LAC,LAC-2005,82,20030,2924,6368,0.459,231,669,0.345,2693,5699,0.473,1770,2274,0.778,980,2455,3435,1901,599,422,1290,1819,7849
2005,Houston Rockets,HOU,HOU-2005,82,19855,2846,6419,0.443,553,1521,0.364,2293,4898,0.468,1551,1986,0.781,874,2601,3475,1733,563,378,1135,1807,7796
2005,Chicago Bulls,CHI,CHI-2005,82,19830,2849,6592,0.432,511,1433,0.357,2338,5159,0.453,1536,2048,0.75,1001,2591,3592,1743,576,369,1371,2028,7745
2005,Charlotte Hornets,CHA,CHA-2005,82,19880,2961,6859,0.432,320,881,0.363,2641,5978,0.442,1487,2096,0.709,1083,2335,3418,1794,695,440,1192,1894,7729
2005,Memphis Grizzlies,MEM,MEM-2005,82,19705,2802,6271,0.447,531,1486,0.357,2271,4785,0.475,1526,2024,0.754,887,2307,3194,1716,699,476,1197,1910,7661
2005,Detroit Pistons,DET,DET-2005,82,19955,2851,6421,0.444,363,1053,0.345,2488,5368,0.463,1588,2150,0.739,1054,2507,3561,1787,576,497,1133,1638,7653
2005,Indiana Pacers,IND,IND-2005,82,19905,2668,6169,0.432,542,1575,0.344,2126,4594,0.463,1748,2206,0.792,868,2418,3286,1489,615,357,1173,1890,7626
2005,Utah Jazz,UTA,UTA-2005,82,19780,2828,6301,0.449,250,762,0.328,2578,5539,0.465,1719,2272,0.757,1047,2243,3290,1826,541,374,1292,2189,7625
2005,Portland Trail Blazers,POR,POR-2005,82,19730,2896,6422,0.451,420,1161,0.362,2476,5261,0.471,1409,1944,0.725,970,2404,3374,1722,583,544,1308,1703,7621
2005,Atlanta Hawks,ATL,ATL-2005,82,19855,2942,6672,0.441,304,973,0.312,2638,5699,0.463,1417,1994,0.711,1100,2335,3435,1614,629,344,1319,2009,7605
2005,New Jersey Nets,NJN,NJN-2005,82,19905,2753,6419,0.429,435,1203,0.362,2318,5216,0.444,1555,2039,0.763,855,2387,3242,1772,650,308,1164,1985,7496
2005,New Orleans Pelicans,NOP,NOP-2005,82,19930,2718,6556,0.415,415,1316,0.315,2303,5240,0.44,1401,1830,0.766,1019,2281,3300,1724,550,310,1217,1883,7252
2004,Dallas Mavericks,DAL,DAL-2004,82,19805,3322,7230,0.459,507,1456,0.348,2815,5774,0.488,1475,1854,0.796,1174,2538,3712,1963,656,437,1000,1609,8626
2004,Sacramento Kings,SAC,SAC-2004,82,19780,3103,6711,0.462,601,1498,0.401,2502,5213,0.48,1626,2044,0.795,888,2492,3380,2152,710,325,1137,1586,8433
2004,Los Angeles Lakers,LAL,LAL-2004,82,19855,3028,6676,0.454,365,1115,0.327,2663,5561,0.479,1631,2352,0.693,1001,2535,3536,1948,682,379,1132,1732,8052
2004,Milwaukee Bucks,MIL,MIL-2004,82,19780,2970,6650,0.447,401,1145,0.35,2569,5505,0.467,1698,2192,0.775,960,2502,3462,1872,554,383,1110,1668,8039
2004,Denver Nuggets,DEN,DEN-2004,82,19730,2993,6763,0.443,331,985,0.336,2662,5778,0.461,1655,2159,0.767,1083,2387,3470,1794,745,520,1278,1804,7972
2004,Seattle SuperSonics,SEA,SEA-2004,82,19805,2939,6590,0.446,723,1936,0.373,2216,4654,0.476,1363,1782,0.765,907,2318,3225,1782,661,387,1188,1784,7964
2004,Memphis Grizzlies,MEM,MEM-2004,82,19880,2963,6657,0.445,447,1314,0.34,2516,5343,0.471,1557,2143,0.727,1047,2381,3428,1915,795,565,1226,1903,7930
2004,Boston Celtics,BOS,BOS-2004,82,19705,2843,6415,0.443,553,1599,0.346,2290,4816,0.475,1572,2095,0.75,851,2440,3291,1683,770,331,1332,1837,7811
2004,Los Angeles Clippers,LAC,LAC-2004,82,19805,2817,6579,0.428,329,1024,0.321,2488,5555,0.448,1808,2302,0.785,1149,2416,3565,1653,594,376,1344,1816,7771
2004,Minnesota Timberwolves,MIN,MIN-2004,82,19755,3033,6571,0.462,326,897,0.363,2707,5674,0.477,1361,1743,0.781,875,2645,3520,1890,561,462,1043,1731,7753
2004,Phoenix Suns,PHX,PHX-2004,82,19730,2958,6671,0.443,415,1202,0.345,2543,5469,0.465,1392,1865,0.746,924,2406,3330,1586,734,383,1249,1862,7723
2004,Orlando Magic,ORL,ORL-2004,82,19830,2904,6768,0.429,429,1248,0.344,2475,5520,0.448,1474,2000,0.737,1003,2350,3353,1584,547,308,1123,1744,7711
2004,Golden State Warriors,GSW,GSW-2004,82,19855,2875,6511,0.442,429,1283,0.334,2446,5228,0.468,1470,2028,0.725,1002,2533,3535,1681,576,389,1211,1691,7649
2004,Cleveland Cavaliers,CLE,CLE-2004,82,19855,2922,6753,0.433,247,786,0.314,2675,5967,0.448,1528,2030,0.753,1118,2619,3737,1808,585,537,1216,1743,7619
2004,Atlanta Hawks,ATL,ATL-2004,82,19905,2829,6529,0.433,419,1249,0.335,2410,5280,0.456,1534,1976,0.776,996,2507,3503,1648,627,408,1350,1826,7611
2004,New York Knicks,NYK,NYK-2004,82,19880,2881,6513,0.442,406,1115,0.364,2475,5398,0.459,1374,1732,0.793,950,2543,3493,1695,608,391,1289,1897,7542
2004,New Orleans Pelicans,NOP,NOP-2004,82,19830,2772,6605,0.42,531,1666,0.319,2241,4939,0.454,1454,1937,0.751,1091,2418,3509,1716,708,346,1228,1715,7529
2004,Washington Wizards,WAS,WAS-2004,82,19830,2758,6556,0.421,433,1269,0.341,2325,5287,0.44,1579,2211,0.714,1115,2392,3507,1537,733,406,1439,1712,7528
2004,San Antonio Spurs,SAS,SAS-2004,82,19755,2842,6434,0.442,408,1140,0.358,2434,5294,0.46,1409,2069,0.681,1029,2669,3698,1676,661,537,1203,1667,7501
2004,Indiana Pacers,IND,IND-2004,82,19805,2753,6322,0.435,449,1281,0.351,2304,5041,0.457,1538,2014,0.764,965,2452,3417,1774,726,411,1182,1709,7493
2004,Portland Trail Blazers,POR,POR-2004,82,19980,2898,6467,0.448,381,1102,0.346,2517,5365,0.469,1263,1728,0.731,1040,2376,3416,1768,613,443,1213,1554,7440
2004,Miami Heat,MIA,MIA-2004,82,19755,2729,6417,0.425,485,1357,0.357,2244,5060,0.443,1459,1915,0.762,940,2459,3399,1565,590,313,1137,1812,7402
2004,New Jersey Nets,NJN,NJN-2004,82,19705,2813,6372,0.441,377,1123,0.336,2436,5249,0.464,1398,1856,0.753,862,2473,3335,2009,709,322,1209,1722,7401
2004,Detroit Pistons,DET,DET-2004,82,19780,2747,6314,0.435,333,968,0.344,2414,5346,0.452,1561,2074,0.753,1014,2492,3506,1702,659,570,1241,1664,7388
2004,Houston Rockets,HOU,HOU-2004,82,19930,2738,6195,0.442,515,1406,0.366,2223,4789,0.464,1371,1774,0.773,847,2647,3494,1579,560,443,1373,1762,7362
2004,Chicago Bulls,CHI,CHI-2004,82,19830,2798,6753,0.414,429,1256,0.342,2369,5497,0.431,1330,1834,0.725,1048,2519,3567,1793,659,396,1321,1911,7355
2004,Utah Jazz,UTA,UTA-2004,82,19780,2690,6172,0.436,252,786,0.321,2438,5386,0.453,1639,2196,0.746,1103,2272,3375,1671,583,494,1365,2096,7271
2004,Philadelphia 76ers,PHI,PHI-2004,82,19855,2682,6260,0.428,339,992,0.342,2343,5268,0.445,1512,2009,0.753,941,2408,3349,1640,654,358,1307,1701,7215
2004,Toronto Raptors,TOR,TOR-2004,82,19980,2654,6348,0.418,461,1294,0.356,2193,5054,0.434,1237,1650,0.75,830,2419,3249,1574,604,402,1164,1748,7006
